###############################.################################################
#..............................................................................#
#..............................................................................#
#....................................aze.......................................#
#..............................................................................#
#..............................................................................#
#..............................................................................#
#..............................................#...............................#
#..............................................................................#
#..............................................................................#
#..............................................................................#
#..............................................................................#
#..............................................................................#
#..............................................................................#
#..............................................................................#
#..............................................................................#
#..............................................................................#
#..............................................................................#
#..............................................................................#
#..............................................................................#
#..............................................................................#
#..............................................................................#
#..............................................................................#
################################################################################